1,1,1,1,1,1,1,1,1,1,1,1,1,1,1,1,1,1,1,1,1,1,1,1,1,1,1,1,1,1,
1,0,0,0,0,0,0,4,4,4,4,0,0,0,0,0,0,0,0,0,0,0,0,0,0,0,0,0,0,1,
1,0,5,0,4,4,4,4,0,0,3,3,3,3,7,3,3,3,3,7,3,3,3,3,3,3,3,0,0,1,
1,0,0,0,0,0,0,0,0,0,3,0,0,0,0,0,0,5,0,0,0,0,0,0,0,0,3,0,0,1,
1,3,3,0,0,0,0,0,0,0,0,0,5,0,0,0,0,0,0,0,0,0,0,0,0,0,0,0,0,1,
1,3,0,0,0,0,0,0,0,0,0,0,0,0,0,0,0,0,0,7,7,7,7,7,0,0,0,5,0,1,
1,7,0,0,4,0,0,0,0,0,0,0,0,0,0,0,0,0,0,0,0,0,0,0,0,3,0,0,0,1,
1,3,3,0,4,0,3,3,3,3,3,3,7,3,3,3,3,3,3,3,0,0,0,0,0,3,3,0,0,1,
1,0,3,0,4,0,0,0,0,0,0,0,0,0,0,0,0,0,0,3,4,4,4,0,0,0,3,0,0,1,
1,0,3,0,4,0,0,0,0,0,0,0,0,0,0,0,0,0,0,3,4,4,4,0,0,0,3,0,0,1,
1,0,3,3,4,0,0,0,0,0,0,0,0,0,0,0,0,0,0,3,4,4,4,0,0,0,3,0,0,1,
1,0,0,3,4,0,0,0,0,0,0,0,0,0,0,0,0,0,0,3,4,4,4,0,0,0,0,3,0,1,
1,0,0,3,0,0,0,3,0,0,0,0,0,0,0,0,3,3,3,3,4,4,4,0,0,0,0,3,0,1,
1,0,0,0,0,0,0,3,0,0,0,0,0,0,0,0,0,0,0,0,0,0,0,0,0,0,0,3,0,1,
1,0,0,0,0,0,0,3,0,0,0,0,0,0,0,0,0,0,0,0,0,0,0,0,0,0,0,3,0,1,
1,0,0,0,0,0,3,3,0,0,0,0,0,0,0,0,0,0,0,0,0,0,7,7,7,7,0,3,0,1,
1,0,0,0,0,0,3,0,0,0,0,0,3,3,3,3,3,0,0,0,0,7,7,0,0,0,3,3,0,1,
1,0,0,0,0,3,3,0,0,0,0,0,3,0,0,0,3,0,0,0,0,0,0,0,0,0,3,0,0,1,
1,0,3,3,3,3,0,0,0,0,0,0,3,0,6,0,3,0,0,0,0,0,0,0,0,0,0,0,0,1,
1,1,1,1,1,1,1,1,1,1,1,1,1,1,1,1,1,1,1,1,1,1,1,1,1,1,1,1,1,1,